5 1 1 1 1 1 1 1 1 1 1 1 1 1 1 1 1 1 1 6
4 9 9 9 9 0 0 0 0 0 0 0 0 0 0 9 9 9 9 3
4 9 9 9 9 0 0 0 0 0 0 0 0 0 0 9 9 9 9 3
4 9 9 9 9 0 0 0 0 0 0 0 0 0 0 9 9 9 9 3
4 0 0 0 0 0 0 0 0 0 0 0 0 0 0 0 0 0 0 3
4 0 0 0 0 0 0 0 0 0 0 0 0 0 0 0 0 0 0 3
4 0 0 0 0 0 0 0 0 0 0 0 0 0 0 0 0 0 0 3
4 0 0 0 0 0 0 0 0 0 0 0 0 0 0 0 0 0 0 3
4 9 9 9 9 0 0 0 0 0 0 0 0 0 0 9 9 9 9 3
4 9 9 9 9 0 0 0 0 0 0 0 0 0 0 9 9 9 9 3
4 9 9 9 9 0 0 0 0 0 0 0 0 0 0 9 9 9 9 3
7 2 2 2 2 2 2 2 2 2 2 2 2 2 2 2 2 2 2 8